******************
*----------------*
*---------B------*
*---------*------*
*--------**------*
*<------***----->*
***--*************
  ****            
//