******************
*----------------*
*----------------*
*----------------*
*----------------*
*<--------h----->*
******************
//