******************
*                *
*                *
*         *      *
*        **      *
*<      ***     >*
******************
//