******************
*                *
*                *
*                *
*      ***       *
*       *        *
******************
//