******************
*----------------*
*----------------*
*----------------*
*------***-------*
*<------*------->*
******************
//