******************
*                *
*                *
*                *
*                *
*<        h     >*
******************
//