******************
*                *
*                *
*                *
*                *
*<              >*
******************
//