******************
*                *
*                *
*                *
*      ***       *
*<      *       >*
******************
//