******************
*----------------*
*----------------*
*---------*------*
*--------**------*
*<------***----->*
******************
//