******************
*----------------*
*----------------*
*----------------*
*----------------*
*<--------h--B-->*
******************
//