*********************************
*BBBBBBBBBBBBBBBBBBBBBBBBBBBBBBB*
*BBBBBBBBBBBBBBBBBBBBBBBBBBBBBBB*
*B---BBBBBBBBBBBBBBBBBBBBBBBBBBB*
*<---BBBBB┴BBBBBBBBBBB┴BBBBBBBB>*
*********************************
//