*********************************
*BBBBBBBBBBBBBBBBBBBBBBBBBBBBBBB*
*BBBBBBBBBBBBBBBBBBBBBBBBBBBBBBB*
*BBBBBBBBBBBBBBBBBBBBBBBBBBBBBBB*
*<BBBBBBBB┴BBBBBBBBBBB┴BBBBBBBB>*
*********************************
//