*******************************************
*--------------------p--------------------*
*--------------------p--------------------*
*--------------------p--------------------*
*<------------T------p------------------->*
*******************************************
//
14 4 T 21 1 21 2 21 3 21 4
