*******************************************
*--------------------p--------------------*
*--------------------p--------------------*
*--------------------p--------------------*
*<---S--------T------p--------S---------->*
*******************************************
//
14 4 T 21 1 21 2 21 3 21 4
5 4 S bottle 1 2000
30 4 S ooze 3 4000 
