          
          
    ******
   *     *
  *      *
**      >*
*    *****
*   *     
*< *      
***       
//
