          
          
    ******
   *-----*
  *------*
**------>*
*----*****
*---*     
*<-*      
***       
//
