*************************************
*-----------------------------------*
*---------------------------------->*
*---------*├---------------------****
*--------**-------------------------*
*<------***---┴-----h--sssssss----->*
*************************************
//