*************************************
*-----------------------------------*
*---------------------------------->*
*---------*├---------------------****
*--------**-------------------------*
*<------***---┴-----h--ss---------->*
*************************************
//