*************************************
*                                   *
*                                  >*
*         *                      ****
*        **                         *
*<      ***   ┴                    >*
*************************************
//