*************************************
*--B-------------b-******************
*-----------------*--------------****
*<-******--------*------------------*
*----------------*-----********--BBB*
*---------*****----*-----------***BB*
*--------*-----*------------------***
*----**---------*----*******------pp*
*---***----------*---*******------p>*
*************************************
//
17 1 b 34 7 34 8 35 7