******************
*----------------*
*----------------*
*----------------*
*----------------*
*<---o----h--B-->*
******************
//