******************
*----------------*
*---------B------*
*---------*------*
*--------**------*
*<------***----->*
******************
//