************************************
*----------------------------------*
*b---------------------------------*
***-----------------------pp********
*------------------------p---*******
*****----****************-----******
*-------*BBBBBBBBBBBBBBBB*-----*****
*------P-BBBBBBBBBBBBBBBBB*--------*
*<----P-BBBBBBBBBBBBBBBBBBB*------>*
************************************
//
1 2 b 7 7 6 8 25 4 26 3 27 3