    ********************************
   *-------------------------------*
  *--------------------------------*
**-------------------------B------>*
*------------------------***********
*----------------***-----***********
*<-------o----*----------***********
**************-----------***********
//
