**************
*------------*
*b-----------*
*------****-**
*-----p---*hh*
*<---pBBBB*h>*
***********pp*
//
1 2 b 5 5 11 6 12 6 6 4