    ********************************
   *-------------------------------*
  *--------------------------------*
**----B--------------------B------>*
*----*********-----------***********
*---**********-----------***********
*<--**********--o--------***********
************************************
//
