*************************************
*-----------------------------------*
*---------------------------------->*
*---------*---------------------┤****
*--------**-------------------------*
*<------***---┴-----h-------------->*
*************************************
//