*************************************
*                                   *
*                                  >*
*         *                      ****
*        **                         *
*<      ***                        >*
*************************************
//