************************************
*----------------------------------*
*b---------------------------------*
***-----------------------pp********
*------------------------p---*******
******---****************-----******
*-------*BBBBBBBBBBBBBBBB*-----*****
*------p-BBBBBBBBBBBBBBBBBp--------*
*<----p-BBBBBBBBBBBBBBBBBBBp------>*
************************************
//
1 2 b 7 7 6 8 25 4 26 3 27 3 26 7 27 8