*****************************
*------*----*----*----------*
*<-----s----s----s----------*
*---------------------------*
*---------------------------*
*---------------------------*
*---------------------------*
*---------------------------*
*-┴┴┴┴┴┴┴┴┴┴┴┴┴┴┴┴┴┴┴┴┴---->*
*****************************
//