******************
*                *
*                *
*                *
*      ***       *
*                *
******************
//