*************************************
*                                   *
*                                  >*
*         *                     ┤****
*        **                         *
*<      ***   ┴     h              >*
*************************************
//