******************
*----------------*
*----------------*
*------p---------*
*------***-------*
*<-----b*------->*
******************
//
7 5 b 7 3
