*******************************************************************
*ssssssssssssssssssssssssssss**************************************
*----------------------------sssssssssssssssssssssss***************
*--------------------------------------------------------**********
*------------------------------------B-B-B-B-----------------******
*-----------------------*******************************------******
*-----------------------ssssssssssssssssssssssssssssss-------******
*---------------------------s----------------------------**********
*<--------o-----------------*--------------------------------******
*****************************---BBBBBBB-----------------------*****
********************************************************-------****
*******************************s--------------------------------***
********************************s--------------h-----------------**
*********************************s-------**************************
**********************************s------------------------------**
***********************************s-----------------------------**
************************************************************---->**
*******************************************************************
//