*************************************
*-----------------------------------*
*-----------------------------------*
*------sssssssssssssssssssssss-----*
*-----------------------------------*
*<--------------------------------->*
****-----------------------------****
*-----------------------------------*
*----o--------o--------o-------o----*
*************************************
//